                                                                                
  [38;5;2m           [0m                                                                   
  [38;5;2m            [0m[1;4;38;5;8m*[0m                      _               ____                       
  [38;5;2m           >><[0m                    / \      ___    / ___|                      
  [38;5;2m          >><<<[0m                  / _ \    / _ \  | |                          
  [38;5;2m         >><<<<<[0m                / ___ \  | (_) | | |___                       
  [38;5;2m        >><<<><<<[0m              /_/   \_\  \___/   \____|                      
  [38;5;2m       >><>>><<<<<[0m                                                            
  [38;5;2m      >><<>>><<<<><[0m             ____     ___    ____    ____                  
  [38;5;2m     >><>>><<<<<><<<[0m           |___ \   / _ \  |___ \  | ___|                 
  [38;5;2m    >><<<><<<<<><<<<<[0m            __) | | | | |   __) | |___ \                 
  [38;5;2m   >>><<<<>>><<<<<<><<[0m          / __/  | |_| |  / __/   ___) |                
  [38;5;2m  >><<<>>>><>><<<><<<<<[0m        |_____|  \___/  |_____| |____/                 
  [38;5;2m >>>><<<>>>>>><>>><>><<<[0m                                                      
  [38;5;2m><>><>>>><<<<>>>><<<<<><<[0m                                                     
  [38;5;2m           [0m[38;5;8m| |[0m                                                                
                                                                                
