                                                                                
  [38;5;2m           [0m                                                                   
  [38;5;2m            [0m[1;4;38;5;8m*[0m                      _               ____                       
  [38;5;2m           >><[0m                    / \      ___    / ___|                      
  [38;5;2m          >><<<[0m                  / _ \    / _ \  | |                          
  [38;5;2m         >><<<<<[0m                / ___ \  | (_) | | |___                       
  [38;5;2m        >><<<><<<[0m              /_/   \_\  \___/   \____|                      
  [38;5;2m       >><>>><<<<<[0m                                                            
  [38;5;2m      >><<>>><<<<><[0m             ____     ___    ____    _  _                  
  [38;5;2m     >><>>><<<<<><<<[0m           |___ \   / _ \  |___ \  | || |                 
  [38;5;2m    >><<<><<<<<><<<<<[0m            __) | | | | |   __) | | || |_                
  [38;5;2m   >>><<<<>>><<<<<<><<[0m          / __/  | |_| |  / __/  |__   _|               
  [38;5;2m  >><<<>>>><>><<<><<<<<[0m        |_____|  \___/  |_____|    |_|                 
  [38;5;2m >>>><<<>>>>>><>>><>><<<[0m                                                      
  [38;5;2m><>><>>>><<<<>>>><<<<<><<[0m                                                     
  [38;5;2m           [0m[38;5;8m| |[0m                                                                
                                                                                
