[10/1] ✔ Input obtained
Calculating answer for 10/1
[10/1] ✔ Answer 'answer' calculated in {}
[10/1]
[38;5;9m ,=*,         ,*=,[0m                                                              
[38;5;9m:####=,     ,=####:[0m                                                             
[38;5;9m '#####=   =#####'[0m      _                       _                               
[38;5;9m   '#####+#####'[0m       | |_    ___     ___     | |   ___   __      __           
[38;5;9m     '#######'[0m         | __|  / _ \   / _ \    | |  / _ \  \ \ /\ / /           
[38;5;9m     ,*#####*,[0m         | |_  | (_) | | (_) |   | | | (_) |  \ V  V /            
[38;5;9m   ,*####*####*,[0m        \__|  \___/   \___/    |_|  \___/    \_/\_/             
[38;5;9m ,*####+   +####*,[0m                                                              
[38;5;9m:####*'     '*####:[0m                                                             
[38;5;9m '*#'         '#*'[0m                                                              
                                                                                
Submitting answer 'answer'
